###################
### ######B########
#      ##    ######
#####   #### ######
A             #####
###################