#####B###
##    ###
#### # ##
###A # ##
###  ####
## ######
#########